Nume și porecle

岡部倫太郎 -> Okabe Rintarou
- 鳳凰院凶真 -> Hououin Kyouma
- オカリン (Mayuri, Daru) -> Okarin
- 岡部さん (Luka) -> Okabe
- 鳳凰院凶真さん (Kurisu) -> Domnul Hououin Kyouma / Hououin Kyouma
- 鳳凰院さん (Kurisu) -> Domnul Hououin
- 凶真さん (Luka) -> Kyouma
- 凶真 (Feiris) -> Kyouma

椎名まゆり -> Shiina Mayuri
- マユシィ・ニャンニャン -> Mayushii Miau-Miau
- まゆしぃ (Mayuri) -> Mayushii
- まゆ氏 (Daru) -> Mayushi
- まゆりちゃん (Braun) -> Mayuri

橋田至 -> Hashida Itaru
- ダル (Okabe) -> Daru
- ダルくん (Mayuri) -> Daru
- 橋田さん (Kurisu) -> Hashida

牧瀬紅莉栖 -> Makise Kurisu
- 牧瀬さん -> Domnișoara Makise
- クリスティーナ (Okabe) -> Cristina
- 天才少女 (Okabe) -> Fata genială
- ザ・ゾンビ (Okabe) -> Zombiul
- 牧瀬氏 (Daru) -> Domnișoara Makise
- 牧瀬さん (Luka) -> Domnișoara Makise
- 紅莉栖ちゃん (Mayuri) -> Kurisu

桐生萌郁 -> Kiryuu Moeka
- 閃光の指圧師 (Okabe) -> Deget-Fulger

漆原るか -> Urushibara Luka
- るかくん (Mayuri) -> Luka

フェイリス・ニャンニャン -> Feiris Miau-Miau
- フェイリスたん (Daru) -> Feiris
- フェリスちゃん (Mayuri) -> Feris

阿万音鈴羽 -> Amane Suzuha
- 鈴さん (Mayuri) -> Suzuha
- バイト (Braun) -> Suzuha
- バイト戦士 (Okabe) -> Soldat Part-Time

ジョンタイター -> John Titor

中鉢 -> Nakabachi

天王寺裕吾 -> Yuugo Tennouji
- 寺裕吾さん -> Domnul Tennouji
- ミスターブラウン (Okabe) -> Domnul Braun
- ブラウンしぃ (Daru) -> Domnul Braun

Termeni în ordinea apariției

Episodul 1
エル・プサイ・コングルゥ -> El Psy Kongroo
機関 -> Organizația
世界線 -> Linii ale lumii
うーぱ -> Upa
メール -> Mail
未来ガジェット -> Invenție a Viitorului
トゥットゥルー -> Tutturu
未来ガジェット研究所 -> Laboratorul de Invenții ale Viitorului
スーパーハカー -> Super hacher
ハッカー -> Hacker
ラジ館 -> Clădirea Radio
シュタインズゲート -> Steins Gate
ドクペ -> Dr. Pepper
電話レンジ（仮） -> Telefonul cu Microunde (nume temporar)
ゲルバナ -> Gel-nană
ジューシーからあげナンバーワン -> Puiul Prăjit Suculent Numărul 1
メイクイーン+ニャン² -> MayQueen+Nyan²

Episodul 2
柳林神社 -> Altarul Yanabayashi
妖刀五月雨 -> Sabia Magică Samidare
＠ちゃんねる -> Forumul @channel
ご主人様 -> Stăpân
ギアナ高地 -> Țările din Guiana

Episodul 3
Zプログラム -> Programul Z

Episodul 4
ゼリーマンズレポート -> Raportul Jellyman
スターダストシェイクハンド -> Strângere de mână stelară
雷ネットバトル -> Rai-Net Access Battlers